Md^Xm, Md^Xm, Md^Xm, Md^Xm, Md^Xm, Md^Xm, Md, Gd, Md^Qhh, Md^Xm, Md^Qhh, Hhd^Qhh, Md^Qhh, Md^Qhh, Wwg, Wog, Hhd, Md^Qhh, Md, Md^Xm, Md^Xm
Md^Xm, Md^Xm, Md, Md^Xm, Md, Md^Xm, Md, Md^Qhh, Hhd^Qhh, Md^Qhh, Hhd^Qhh, Hhd^Qhh, Gd^Qhh, Gd^Qhh, Wwg, Wog^Ewl, Gd^Es, Md^Qhh, Hhd^Qhh, Md^Xm, Md^Xm
Md^Xm, Md^Xm, Md^Xm, Md, Md, Md, Md^Qhh, Md^Qhh, Md^Qhh, Hhd^Qhh, Hhd^Qhh, Hhd^Qhh, Wwf^Wkf, Wwf^Wkf, Md, Hhd, Hhd^Qhh, Hhd^Qhh, Md^Qhh, Md^Xm, Md^Xm
Md^Xm, Md^Xm, Md^Xm, Md, Md, Md^Qhh, Hhd^Qhh, Md^Qhh, Gd^Fp, Hhd^Vhh, Gll^Emf, Hhd^Qhh, Hhd^Qhh, Wwf^Es, Wwg, Hhd, Hhd^Qhh, Md^Qhh, Md, Md^Xm, Md^Xm
Md, Md, Md^Qhh, Md, Md, Md^Qhh, Gll^Qhh, Gd^Qhh, Wwf^Wkf, Gll^Es, Wwf^Ewf, Hhd^Qhhf, Hhd^Qhhf, Wwg, Gll^Em, Md, Md^Xm, Md^Xm, Md, Md, Md^Xm
Md, Md^Qhh, Hhd^Qhh, Md^Qhh, Md^Qhh, Md^Qhh, Gll^Em, Gll^Qhh, Wwf^Es, Wwf^Ewl, Gd, Wwg^Wkf, Wwg^Wkf, Wog, Wog, Md, Hhd^Dr, Md^Xm, Md, Md^Xm, Md^Xm
Md^Xm, Md^Qhh, Md^Qhh, Hhd^Qhh, Hhd^Qhh, Gd, Gd^Fmw, Sm, Gd^Es, Hhd, Hhd^Feth, Wwf^Wkf, Md, Md, Hhd^Emf, Wwg, Hhd, Md, Md, Md^Xm, Gd^Fp
Md^Xm, Md^Xm, Md^Qhh, Hhd^Qhh, Hhd^Qhh, Gd^Qhhf, Gd^Fp, Sm, Sm^Wkf, Sm^Wkf, Sm, Wwf^Ewl, Md, Md, Hhd, Wog, Wwg, Hhd, Gll^Es, Hhd^Es, Gd
Md, Md^Qhh, Hhd^Qhh, Md^Qhh, Gll, Gll, Gll^Efm, Gd, Sm, Sm^Wkf, Sm^Wkf, Md, Gll^Fp, Gd^Fp, Wwf^Es, Gd, Wwf^Wkf, Wwg, Gd^Efm, Gd^Vc, Hhd
Md^Xm, Md^Qhh, Md^Qhh, Hhd^Qhh, Hhd^Qhh, Gd, Wwf^Es, Wwf^Es, Hhd, Hhd^Emf, Hhd^Emf, Hhd, Gll^Fp, Gll^Fmw, Gll^Fp, Wwf^Wkf, Hhd, Gd^Efm, Hhd^Fdw, Hhd^Fetd, Md
Md^Xm, Md^Xm, Md^Xm, Hhd^Qhh, Md^Xm, Md^Qhh, Hhd^Qhhf, Wwf^Vm, Wwrg, Wwrg, Kme, Hhd, Wwf^Wkf, Sm, Sm, Wwf, Wwf^Es, Hhd^Fdw, Md, Md, Md
Md, Md^Xm, Md, Sm, Md^Xm, Md^Xm, Md^Qhh, Hhd^Qhh, Wog, Cme, Cme, Wwf^Vm, Wwg^Wkf, Wwf^Wkf, Wwf, Wwf, Wwg, Md, Wwf, Md, Md
Sm, Hhd, Wwf^Wkf, Wwf^Es, Wwrg, Wwrg, Wwg, Wwg^Wkf, Wwg^Wkf, Wog, Wwg, Wwg, Wwrg, Wwg, Wwg, Wwrg, Wwrg, Wwg^Wkf, Wwg^Wkf, Wwf^Es, Md
Sm, Sm^Wkf, Wwf^Wkf, Wwrg, Wog, Wwrg, Wwg, Wwg^Wkf, Wwrg, Wwrg, Wwg^Wkf, Wwrg, Wwrg, Wwrg, Wwg^Qhh, Wwrg^Qhh, Wwg^Qhh, Wwrg^Qhu, Wog^Qhu, Wwg, Md
Wwrg^Wkf, Wwg, Wwg, Wwg, Wog, Wog, Wog, Wog, Wwg, Wwg^Vm, Wwrg, Wwg, Wog^Qhu, Wwrg^Qhu, Wog^Qhh, Km^Qhh, Wwg^Qhh, Wog^Qhh, Wog^Qhu, Wwg, Wwg
Wwrg, Wwrg, Wog, Wwg, Wog, Wog, Wog, Wog, Wog, Wwg, Wog, Wog, Wog^Qhu, Wog^Qhh, Wog, Wog^Qhh, Wwrg^Qhu, Wwrg^Qhu, Wog, Wog, Wog
Wwg, Wwrg, Wog, Wog, Wog, Wog, Wog, Wog, Wog, Wog, Wog, Wog, Wog, Wog, Wog, Wog, Wog, Wwg^Qhu, Wog, Wog, Wog
