Md^Xm, Md^Xm, Md^Xm, Md, Md^Xm, Md, Md^Xm, Md^Xm, Md^Xm, Md^Xm, Md^Xm, Md, Md, Md, Md^Xm, Md^Xm, Md^Xm, Md^Xm, Md^Xm, Md^Xm, Xu, Xu, Xu, Xu, Xu, Xu, Xu, Xu, Xu, Xu, Xu, Xu, Xu, Xu, Xu, Md^Xm, Md^Xm, Md^Xm, Md^Xm, Md^Xm, Md^Xm, Md^Xm, Md, Md, Hhd^Fmw, Gs^Fmw, Hhd, Gd, Hhd^Fp, Hhd^Fp, Hhd^Fdw, Md, Md, Md, Md^Xm, Md^Xm, Hhd, Hhd, Md, Md, Md, Md^Xm, Md^Xm
Md^Xm, Md^Xm, Md^Xm, Md, Md, Md^Xm, Md^Xm, Md^Xm, Md^Xm, Md^Xm, Md^Xm, Md^Xm, Md, Md, Md, Md^Xm, Md^Xm, Md^Xm, Md^Xm, Xu, Xu, Xu, Xu, Xu, Xu, Xu, Xu, Xu, Xu, Xu, Xu, Xu, Uh^Em, Uh^Emf, Xu, Xu, Md^Xm, Md^Xm, Md^Xm, Md^Xm, Md^Xm, Md, Md, Md, Md^Xm, Hhd^Fmw, Hhd, Gd^Em, Gll^Feth, Hhd^Fdw, Hhd, Hhd, Wog^Wkf, Md, Wwg, Md^Xm, Wwrg, Gd^Fdw, Md^Xm, Md, Hhd^Fp, Md, Md
Md, Md^Xm, Md^Xm, Md, Md, Md, Md, Md^Xm, Md^Xm, Md, Md, Md, Md^Xm, Md^Xm, Md^Xm, Md^Xm, Md^Xm, Md^Xm, Xu, Xu, Xu, Xu, Xu, Xu, Xu, Chw, Khw, Uh, Uh^Em, Uu^Tf, Xu, Xu, Uu^Dr, Uu, Uu^Tf, Uh^Tf, Xu, Md^Xm, Md^Xm, Md^Xm, Md, Md, Hhd, Md, Md^Xm, Md^Xm, Hhd^Fp, Hhd^Fmw, Gll^Emf, Gll^Es, Wwf, Hhd, Wog^Wkf, Wog^Wkf, Wwg, Wog, Wwrg, Wwrg, Md^Xm, Md^Xm, Hhd, Hhd^Fp, Md
Md, Md, Md, Md, Md, Md, Md, Md^Xm, Md, Md, Md^Xm, Md, Md^Xm, Md^Xm, Md^Xm, Md^Xm, Md^Xm, Md^Xm, Xu, Xu, Uh^Tf, Uh^Tf, Uh^Emf, Wwr, Wwr^Ii, Chw^Ii, Wwr, Wwr, Wwf^Es, Wwf^Es, Xu, Xu, Xu, Uu^Emf, Xu, Xu, Md^Xm, Md^Xm, Md^Xm, Md, Wwf^Es, Md, Hhd, Md, Md, Md, Hhd^Fp, Hhd^Fp, Gd^Es, Gd^Efm, Gd^Efm, Wwf, Hhd^Fdw, Wwg, Sm^Es, Sm, Wwf^Wkf, Md^Xm, Md^Xm, Md^Xm, Md, Md, Md
Md^Xm, Md, Hhd^Fdw, Hhd^Fp, Gd^Fmw, Gd^Fp, Hhd^Fp, Md, Md, Md, Md^Xm, Md^Xm, Md^Xm, Md^Xm, Md^Xm, Md^Xm, Md^Xm, Xu, Xu, Uh^Dr, Uu^Emf, Uu^Tf, Wwf^Es, Wwf^Dr, Ww^Ii, Ww^Ii, Wwr^Qhu, Wwr, Wwf^Qhu, Xu, Xu, Uh^Emf, Uu^Emf, Uu, Xu, Xu, Md^Xm, Md^Xm, Md, Md^Xm, Wwrg, Wwf^Es, Wwg^Wkf, Wwf^Wkf, Wwf, Md, Hhd^Fp, Hhd^Vc, Wwg, Gd^Efm, Hhd^Fdw, Hhd^Fmw, Hhd, Wwf, Wwf^Wkf, Sm^Wkf, Cme, Md^Xm, Sm^Ewl, Sm^Ewl, Sm^Wkf, Sm^Wkf, Ss
Md^Xm, Md^Xm, Md, Hhd^Fp, Gll^Fdw, Gd^Efm, Hhd^Emf, Md, Md, Md^Xm, Wwf^Es, Md, Hhd^Fmw, Hhd^Fp, Md, Md^Xm, Md^Xm, Xu, Xu, Uh^Emf, Uu^Vu, Uh, Ww^Ii, Wwf^Ii, Uue^Ii, Wwf^Ii, Ww^Qhu, Wwr^Qhu, Ww^Qhu, Ww^Qhu, Wo, Uh^Ii, Wo^Ii, Uu^Tfi, Uh, Xu, Xu, Kme, Cme, Wog^Dr, Wog, Wog, Wog, Wwg^Wkf, Wwf, Hhd^Fp, Wwf^Es, Wog, Wog, Wwg^Wkf, Wog, Hhd^Fdw, Wwrg, Wwf^Wkf, Wwf^Wkf, Cme, 1 Kme, Cme, Wwf^Wkf, Sm^Ewl, Sm, Sm^Wkf, Sm
Md^Xm, Md^Xm, Md, Gll^Fp, Gll^Feth, Gd^Es, Gd^Fdw, Md, Md, Wwf, Wwf, Wwf^Wkf, Ww^Wkf, Gll^Fdw, Md, Md^Xm, Md^Xm, Md^Xm, Xu, Xu, Ww, Ww^Qhu, Wo^Qhu, Uhe, Xue, Xue, Ql^Qhux, Ww^Qhu, Wo^Qhu, Wo^Qhu, Wo^Qhu, Wo^Ii, Wwr^Ii, Ww^Ii, Wog^Pr/, Xu, Wwf^Es, Wwf, Wwg^Wkf, Wog, Wog^Wkf, Wog, Wwrg, Wwf, Wwf^Es, Wwf, Wwf, Gd, Gd^Es, Wwf^Es, Gd, Wwg, Wwrg, Wwrg, Wwf^Ewl, Cme, Wwg^Ewl, Wwg^Ewf, Sm^Ewl, Sm, Sm^Vhs, Hhd, Hhd
Md, Md, Md, Md, Hhd, Gd^Fdw, Gll^Fp, Gll^Fp, Wwr, Ww^Wkf, Wo, Wo^Wkf, Ww, Ww, Hhd^Fmw, Md, Md, Xu, Xu, Ww, Wwr^Qhu, Ww^Qhu, Wo^Qhu, Wo^Qhu, Ql^Qhux, Xue, Qlf, Ql^Qhux, Ql^Qhux, Wo^Qhu, Wo^Qhu, Wwr^Ii, Wwr, Xu, Xu, Wwf, Hhd^Emf, Wwg^Dr, Wwrg, Wwg^Vm, Wwg^Wkf, Wwrg, Hhd, Hhd, Md, Md, Hhd, Hhd^Em, Hhd^Em, Gd, Gll, Ss, Sm, Wwf, Wwf^Dr, Wwf^Ewf, Wwf^Ewl, Wwf^Ewf, Sm^Wkf, Sm, Md, Md, Md^Xm
Md^Xm, Md, Md^Xm, Md, Md, Hhd^Fmw, Gd, Gd^Fmw, Ww^Wkf, Ww^Qhh, Cm^Qhh, Wo^Qhh, Ww^Wkf, Wwr, Wwr, Md, Xu, Xu, Xu, Uu, Uh^Ii, Wwr^Qhu, Ww^Qhu, Wo^Qhu, Ql^Qhux, Qlf, Mv, Qlf, Ql^Qhux, Ww^Qhu, Ww^Qhu, Ww^Qhu, Wwr, Md, Md^Xm, Md^Xm, Md, Cme, Wwf, Wwrg, Md, Wwf^Es, Wwf, Md, Md, Md, Md^Xm, Hhd^Emf, Hhd^Fp, Gll, Gll^Es, Ss, Ss^Bw/r, Ss^Bw/r, Sm^Wkf, Sm^Es, Sm, Sm, Sm, Hhd, Hhd, Md^Xm, Md^Xm
Md^Xm, Md^Xm, Md, Md, Md^Xm, Md^Xm, Wo^Wkf, Wo^Wkf, Ww^Wkf, Wwr^Qhh, Wwr^Qhh, Ww^Ewl, Wo^Ewf, Wwr, Wwf^Es, Sm^Xo, Sm^Xo, Cme, Kme^Ii, Uh^Ii, Ww^Ii, Wo^Ii, Ww^Qhu, Ql^Qhux, Qlf, Md, Md, Md, Qlf, Ql^Qhux, Ql^Qhux, Wwr^Qhu, Wo^Qhu, Hhd^Vc, Md^Xm, Md^Xm, Md^Xm, Md^Xm, Md, Md^Xm, Md^Xm, Hhd, Wwrg, Md^Xm, Md^Xm, Md, Md, Md, Hhd^Fp, Gll, Gll^Em, Gd^Emf, Ss, Ss^Wkf, Ss^Wkf, Ss, Ss, Ss, Ss, Ss, Hhd, Md, Gll
Md^Xm, Md^Xm, Md, Md, Md^Xm, Md^Xm, Md^Xm, Wwr, Wwr, Ww^Ewl, Ww^Ewl, Ww^Ewf, Ww, Wo^Wkf, Md, Sm^Xo, Wwf^Dr, Cme^Dr, Cme^Ii, Cme^Ii, Wo, Wo, Ql^Qhux, Ql^Qhux, Ql^Qhux, Qlf, Qlf, Qlf, Qlf, Ql^Qhux, Ww^Qhu, Wo^Qhu, Wo, Hhd^Em, Md, Md, Xu, Md^Xm, Xu, Md^Xm, Md, Hhd^Emf, Wwrg, Md^Xm, Md^Xm, Md^Xm, Hhd^Em, Hhd^Fp, Gd^Edt, Gll^Fp, Wwf^Es, Wwf, Gd^Em, Gd, Gd, Gd, Ss, Ss, Gd^Es, Ss, Gll^Fp, Gll^Es, Gll
Md, Md, Md, Md, Md, Md, Hhd^Fdw, Wwr, Wo^Wkf, Wo^Es, Wwr, Wwr, Wwf, Md, Xu, Xu, Xu, Wwf^Dr, Xu, Wwr, Ww, Wwr^Qhu, Wwr^Qhu, Ql^Qhux, Ww^Qhu, Ql^Qhux, Uhe^Vu, Uhe, Xue, Uhe, Ww^Qhu, Ww^Qhu, Wo, Wo^Dr, Xu, Xu, Xu, Xu, Md^Xm, Md, Md, Md, Hhd, Wwf^Es, Md^Xm, Md, Wwf^Wkf, Gd^Fp, Wwg, Wwrg, Wwrg, Gd^Efm, Rb, Gd^Vhhr, Gd^Fp, Gd^Fp, Gd, Gd^Emf, Gd, Gd, Gd^Em, Gd^Es, Gd^Fp
Md^Xm, Md, Md, Md, Md, Hhd^Emf, Hhd^Es, Gd^Es, Hhd, Wo^Wkf, Gd^Efm, Wwr, Md, Md, Xu, Xu, Xu, Xu, Uh^Emf, Uh^Em, Wwr, Ww^Qhu, Wo^Qhu, Wo^Qhu, Wo^Qhu, Ww^Qhu, Wwr, Xue, Wo, Wo^Qhu, Wwf^Qhu, Wwf^Qhu, Wwf^Es, Wwr, Uh^Tf, Xu, Xu, Xu, Md^Xm, Md, Md, Cte^Es, Cte^Edt, Wwg, Wwg, Wwf, Gll, Wwf^Wkf, Gll^Edb, Wwg^Wkf, Gll, Rb^Es, Rb, Gd^Fp, Gll^Fp, Gll^Emf, Gll^Emf, Gll, Gll, Gll^Efm, Gll^Efm, Gd^Fp, Gd^Fp
Md^Xm, Md, Md^Xm, Md, Md, Hhd, Md, Hhd^Es, Md, Gll^Em, Hhd^Fp, Gd^Fmw, Hhd^Fetd, Hhd^Xo, Uu^Xo, Uh^Emf, Uh^Tf, Uh^Emf, Uh^Tf, Uh^Dr, Wwr, Ww, Wwf^Es, Ww^Dr, Xu, Ww, Wwr, Wwr, Wo, Wo^Dr, Uh^Tf, Uh^Emf, Uu, Uu^Es, Hhd^Dr, Xu, Xu, Md^Xm, Md^Xm, Md, Md, 5 Ket^Edt, Ce^Edt, Ce^Emf, Wwg^Bw\r, Wwrg, Gll^Fp, Gll, Gll^Edb, Gll^Edb, Gd^Edb, Rb, Gd, Gd, Gll^Es, Gll, Gll, Gll, Gll^Em, Gll, Gd, Gd, Gd
Md^Xm, Md^Xm, Md^Xm, Md, Md, Md, Md^Xm, Md, Md, Hhd, Md, Hhd^Fp, Md, Hhd^Xo, Uh^Tf, Uu, Uh^Tf, Xu, Xu, Xu, Uh, Uu^Em, Uu^Emf, Wwf, Xu, Xu, Wo, Ww, Xu, Wo, Uh^Tf, Uu^Tf, Uh, Uh, Hhd, Hhd^Emf, Md, Md, Md^Xm, Md^Xm, Md^Xm, Md, Wog, Wog, Md, Hhd^Em, Gll^Fp, Gll^Fp, Gd, Gll, Rb^Em, Gd, Gll, Gll, Gll^Fdw, Hhd, Hhd, Hhd, Gd, Gd^Es, Gll^Fmw, Gd, Gll
Md^Xm, Md^Xm, Md, Md, Md, Md^Xm, Md^Xm, Md^Xm, Md^Xm, Md, Md, Md, Md, Xu, Xu, Xu, Xu, Xu, Xu, Xu, Xu, Xu, Xu, Uh, Xu, Xu, Xu, Xu, Xu, Uh^Emf, Xu, Xu, Xu, Xu, Xu, Md, Md^Xm, Md^Xm, Md^Xm, Md^Xm, Md^Xm, Md^Xm, Wog, Md, Md, Md, Hhd^Fp, Hhd^Fp, Hhd^Fdw, Gd^Fdw, Rb, Gd, Gll^Fmw, Gll^Fdw, Hhd^Fp, Hhd^Fmw, Hhd^Fdw, Hhd^Em, Hhd^Emf, Hhd, Hhd^Fp, Gll^Fp, Hhd
