Hhd^Fp, Hhd^Fp, Hhd^Fp, Gd, Hhd^Emf, Gd^Fp, Gd^Fp, Gd^Fp, Gd^Fp, Gd, Gd^Es, Gd, Gll, Gll^Efm, Gll^Efm, Gll, Hhd, Hhd, Md, Md, Md^Xm, Md, Md^Xm, Md, Md^Qhh, Md, Md, Md, Hhd^Fp, Gd^Fp, Gd^Fp, Gd^Fp, Gll^Fmw, Gll, Gll^Em, Hhd, Hhd, Gd, Md, Md, Md, Md, Md
Hhd^Fp, Hhd^Fmw, Hhd^Feth, Hhd, Hhd^Em, Hhd^Emf, Gll^Es, Gd^Fp, Gll, Gd, Gd^Fp, Gd, Gll, Gll, Gll, Gll, Hhd, Hhd, Md, Md^Xm, Md^Xm, Md^Xm, Md^Xm, Md^Qhh, Hhd^Qhh, Md^Qhh, Md, Md, Hhd^Feth, Hhd^Fp, Gll^Fmw, Gd^Fmw, Gd^Fdw, Gll^Fmw, Gll^Es, Gd^Edt, Hhd^Qhh, Md^Qhh, Md^Qhh, Md^Qhh, Md^Qhh, Md, Md
Hhd^Fp, Hhd^Fp, Hhd^Fmw, Hhd^Fmw, Hhd^Fmw, Gd, Gll^Vhr, Gll^Es, Gll^Fp, Gll^Fdw, Hhd^Fmw, Gd^Fp, Hhd, Gd, Gd^Es, Gd^Es, Gd, Hhd^Fp, Hhd^Fmw, Md, Md^Xm, Md^Xm, Md^Qhh, Md^Qhh, Hhd^Qhhf, Hhd^Emf, Hhd^Emf, Hhd, Gd^Vhhr, Gll, Gll, Gd, Gd, Gll^Fdw, Gll, Gll^Qhh, Cfr^Qhh, Cfr^Qhh, Hhd^Qhh, Hhd^Qhh, Md^Qhh, Md, Md
Hhd^Fmw, Hhd^Fmw, Hhd, Hhd^Fdw, Hhd^Fdw, Hhd, Rb^Em, Gd, Gd^Fp, Gd^Fmw, Hhd^Fmw, Hhd^Fmw, Hhd, Hhd, Gd, Gd^Es, Gll^Fp, Hhd^Fp, Hhd^Fp, Md, Md^Xm, Md^Qhh, Hhd^Qhhf, Hhd^Qhhf, Gd^Qhhf, Gd^Qhhf, Gd^Fdw, Gd, Gll^Es, Gll^Es, Gll^Fmw, Gd^Edt, Rb^Edt, Rb^Edt, Rb^Edt, Rb^Emf, Cte^Qhh, 3 Kfr^Qhh, Cfr^Qhhf, Md^Qhh, Md, Md, Md
Gd^Fp, Hhd^Fmw, Hhd^Fp, Hhd, Gd^Es, Gd, Rb, Gd, Gd^Emf, Gd^Fdw, Gd^Fdw, Hhd^Fp, Hhd^Fp, Hhd^Es, Gd, Gll, Gd^Qhhf, Hhd^Qhhf, Hhd^Qhhf, Md^Qhh, Md^Qhh, Md^Qhh, Gd^Qhhf, Gll^Fmw, Gll^Em, Gd^Fdw, Gd^Efm, Gd, Gd, Gd^Es, Rb, Gd^Edt, Rb, Gd^Edt, Gd^Fdw, Gd^Qhh, Gd^Qhh, Cte^Qhhf, Gd^Qhhf, Md^Qhh, Md, Md, Md^Xm
Gd^Fp, Gd^Fp, Gd^Fp, Gll, Gll, Gd, Gd^Efm, Gd^Efm, Gd, Gll, Gll^Es, Gll, Gll, Gd^Efm, Gd^Efm, Gd^Qhhf, Wwg, Hhd^Qhh, Hhd^Qhh, Hhd^Qhh, Gd^Es, Gd^Qhhf, Gll^Fp, Gll^Fdw, Gll^Emf, Gd, Gd^Fmw, Gd, Hhd, Gd, Gd^Edt, Rb^Edt, Gd, Gd^Fp, Hhd^Fmw, Gd^Fmw, Md^Qhh, Gd^Qhh, Md^Xm, Md, Md^Xm, Md, Md^Xm
Gd, Gll, Gll, Gll^Efm, Gd, Gd, Gd, Rb, Rb^Es, Wog, Wog, Wog, Wwg, Wwrg, Wwrg, Wwrg, Wwg, Wog, Wog, Wog, Wwg, Gd^Fp, Wwg^Wkf, Gll^Fp, Gd^Es, Gll, Hhd, Hhd^Fmw, Hhd^Em, Hhd, Gd, Gd^Edt, Gll^Es, Gll^Fmw, Hhd^Fp, Md, Md^Xm, Md^Xm, Md^Xm, Md^Xm, Md^Xm, Md^Xm, Md
Gd^Fmw, Gd^Fp, Hhd^Fp, Gd, Hhd, Gd, Gd, Rb, Wwg, Wog^Bw\r, Hhd^Qhh, Hhd^Qhh, Gd^Qhh, Gd, Gd^Es, Gd^Vc, Hhd^Qhh, Wwg, Gd, Gd, Gd^Efm, Wwg^Wkf, Wog, Wwg, Wwg, Gd, Wwg, Wwrg, Wwrg, Sm^Wkf, Sm^Bw|r, Sm, Gd, Gll, Wwg^Wkf, Md^Qhh, Md^Qhh, Md, Md^Qhh, Md^Qhh, Hhd^Fdw, Md, Md
Hhd^Fp, Hhd^Fmw, Hhd^Fmw, Hhd^Es, Hhd, Gd, Gd^Es, Gd, Gll, Wwf^Wkf, Wwf^Wkf, Md^Qhh, Md^Qhh, Md, Md^Xm, Hhd^Qhh, Md^Qhh, Md^Qhh, Md^Qhh, Hhd^Qhh, Hhd^Qhh, Hhd^Qhh, Gll, Gll, Wwf^Es, Gd, Wog, Wwg^Ewl, Wwf^Es, Sm^Wkf, Wwf^Wkf, Wwf^Wkf, Wwrg, Wwg^Wkf, Wwg^Wkf, Hhd^Qhh, Hhd^Qhh, Md^Qhh, Gd^Qhhf, Hhd^Qhhf, Gll^Fp, Hhd^Fp, Hhd
Hhd^Fp, Hhd^Fp, Hhd^Fmw, Hhd, Hhd, Hhd^Fmw, Wwg^Vm, Gll, Gll, Wwf, Gd^Qhh, Hhd^Qhh, Md^Xm, Md^Xm, Md^Xm, Md^Xm, Md^Xm, Md^Xm, Md^Xm, Md^Qhh, Md^Qhh, Hhd^Qhh, Hhd^Qhh, Gll, Sm^Wkf, Wwg^Vm, Wwg, Wwf, Gll, Wwf^Wkf, Md, Wwf^Wkf, Hhd^Fp, Wog, Wog^Qhu, Wwg^Qhu, Sm^Qhu, Sm^Qhu, Wwg^Qhu, Wwf^Qhu, Sm^Qhu, Gll^Fp, Sm^Qhu
Gd^Fp, Hhd^Fmw, Hhd^Fmw, Hhd^Fmw, Hhd, Wwrg, Wog, Wog, Wog, Wwg, Gd, Md^Xm, Md^Xm, Md^Xm, Hhd^Qhuf, Hhd^Qhu, Wwf, Hhd, Md, Md^Xm, Md^Xm, Md^Qhh, Md^Qhh, Sm, Hhd^Qhh, Wwf^Wkf, Chw^Wkf, Chr^Fdw, Gll^Fp, Gll^Em, Hhd, Md, Gd^Fp, Hhd^Fdw, Hhd^Fp, Wwrg^Qhu, Wwrg^Qhu, Sm^Qhu, Hhd^Qhh, Wwf^Qhu, Hhd^Emf, Sm^Qhu, Sm^Qhu
Gd^Qhhf, Gll^Fp, Hhd^Emf, Hhd, Hhd, Wwrg, Wwg, Wwg, Chw, Gd^Qhh, Hhd, Md, Md, Md^Xm, Hhd, Hhd^Qhu, Wwg^Qhu, Wwf^Es, Md^Xm, Md^Xm, Md, Md^Xm, Md^Xm, Md^Qhh, Md^Qhh, Wwf^Wkf, Hhd^Fp, Khw^Fdw, Hhd^Fp, Hhd^Emf, Wwf, Md, Gll^Fp, Wwf, Wwg^Ewl, Wwrg, Wwrg^Qhu, Sm^Qhu, Md^Xm, Hhd^Qhh, Hhd^Qhh, Md^Qhh, Md^Qhh
Gd^Qhhf, Gd^Qhhf, Gd^Fp, Wog, Wog, Wog, Wwg, Chw, Khw^Qhh, Gll^Qhhf, Hhd, Hhd^Fetd, Hhd^Em, Md^Xm, Md^Xm, Md^Xm, Md^Xm, Md^Xm, Md^Qhh, Md^Qhh, Md^Qhh, Md^Qhh, Hhd^Qhh, Wwg^Qhh, Wwrg, Wog, Wwg^Ewl, Chr, Wwf^Wkf, Hhd, Wwrg, Wwf^Es, Wwf, Wwf^Ewl, Wwg^Ewl, Wog, Wwg, Md, Md^Xm, Md^Xm, Md^Xm, Md^Xm, Md^Xm
Wog, 1 Wog, Wwg, Wog, Gd^Fp, Wwg, Wwf^Wkf, Chr^Qhh, Gll^Qhh, Gll^Efm, Gll, Hhd, Hhd, Md^Xm, Md^Qhh, Md, Md^Xm, Md^Xm, Hhd^Fp, Hhd^Qhh, Gll^Fp, Hhd^Qhhf, Gll^Fp, Wwrg, Wwrg, Wog^Ewl, Wwg^Ewf, Wwg^Wkf, Wwg^Wkf, Wwf, Wwg^Vm, Wwrg, Wwrg, Wog^Ewl, Wog, Wwrg, Hhd^Fdw, Md, Gll^Em, Md, Hhd^Fp, Md^Xm, Md
Gll^Qhh, Wwg^Wkf, Gd^Qhh, Gd^Em, Gd^Fp, Gd^Fp, Wwf, Wwf^Wkf, Gll, Gll, Gd, Hhd^Fp, Md^Qhh, Md^Qhh, Hhd^Qhh, Md^Qhh, Md^Qhh, Md, Hhd^Fmw, Hhd^Fp, Gll^Fp, Gll, Gll^Emf, Gll, Sm, Wwg, Wwf, Wwf, Wwg, Wwrg, Wog, Wwg^Ewf, Wwf, Wwf, Sm, Hhd^Emf, Hhd^Emf, Hhd^Fdw, Gd, Hhd^Fp, Hhd^Qhhf, Md^Qhh, Md^Qhh
Gd^Qhhf, Gd^Qhhf, Hhd^Qhh, Gd^Qhh, Sm, Gd^Fp, Sm^Wkf, Gll, Sm, Ss, Gd, Hhd^Fp, Hhd^Qhh, Hhd^Qhh, Sm, Hhd^Qhh, Hhd^Qhh, Hhd^Fdw, Gd^Fdw, Sm, Wwf^Wkf, Wwf^Wkf, Wwf, Wwf, Sm, Sm, Sm, Wwf^Es, Wwg, Wog, Wog, Wwg, Sm^Wkf, Wwf^Wkf, Sm, Hhd, Gd^Efm, Gd^Fetd, Gd, Gd^Fdw, Gd^Qhhf, Hhd^Qhh, Md^Qhh
Hhd^Fp, Hhd^Qhhf, Hhd^Qhh, Hhd, Gd^Em, Sm^Wkf, Sm^Ewf, Gll^Es, Sm, Sm^Wkf, Wwf^Ewl, Gd^Qhh, Wwf, Gd^Qhh, Wwf^Wkf, Sm^Wkf, Gd, Gd^Fdw, Gd, Sm, Gd^Feth, Wwf^Wkf, Gd^Qhh, Gd^Qhh, Gd^Qhh, Hhd^Qhh, Hhd^Qhhf, Hhd, Gd, Wwg, Gd^Efm, Gll, Sm, Sm^Wkf, Gd^Em, Sm, Gd, Gll, Gll^Vc, Gd^Es, Md^Qhh, Md^Qhh, Md^Xm
Hhd^Fp, Hhd^Fp, Hhd^Fmw, Hhd, Gd^Es, Sm, Wwf^Ewl, Wwf^Ewl, Gd^Qhh, Sm, Wwf^Wkf, Wwf^Ewl, Sm, Gd^Qhh, Wwf^Wkf, Wwf^Wkf, Ss^Vhs, Gd, Sm, Gd^Es, Gd^Es, Sm, Sm^Ewl, Gd^Qhh, Sm, Ss, Gd^Qhhf, Gd^Fp, Gd, Gd^Qhh, Gd^Qhh, Gd^Es, Gd^Qhh, Gd, Gd^Es, Hhd, Hhd, Gll^Fp, Hhd^Qhh, Hhd^Qhh, Md, Md^Xm, Md^Xm
Hhd^Fp, Hhd^Fmw, Gd^Fdw, Gd^Fdw, Gd, Gd, Gd^Fp, Gd^Qhh, Gd^Qhhf, Ss, Ss, Sm, Hhd, Ss, Hhd, Ss, Ss, Ss, Sm, Sm^Wkf, Sm^Wkf, Sm^Ewl, Wwf^Ewf, Sm, Sm, Ss, Ss, Ss, Hhd^Qhhf, Hhd^Qhh, Cvr^Emf, Gd^Qhh, Ce, Hhd^Qhh, Hhd^Es, Hhd^Es, Md^Qhh, Md^Qhh, Md^Qhh, Md, Md, Md, Md
Gll^Emf, Hhd^Fp, Gll^Em, Gd^Fp, Gd^Efm, Gd, Gd^Qhhf, Gd^Qhhf, Gd^Qhhf, Gd, Gd^Qhhf, Ss, Hhd, Hhd, Hhd^Fp, Ss, Hhd^Qhhf, Gd^Qhhf, Gd^Qhhf, Sm, Sm, Ss, Ss, Ss, Gd^Fp, Ss, Ss, Hhd^Es, Hhd^Fdw, Cvr, Cvr^Fp, 4 Kvr, Ce^Es, Hhd, Gd, Hhd, Hhd^Qhhf, Hhd^Qhhf, Md^Qhh, Md^Xm, Md, Md, Md
Gll^Emf, Gll^Emf, Gll^Fetd, Gd^Efm, Gd^Es, Gd, Gll, Gd^Qhh, Gd^Qhhf, Gd^Qhhf, Hhd^Qhhf, Hhd^Fmw, Hhd^Fdw, Hhd^Emf, Hhd^Fp, Hhd^Fp, Hhd^Qhhf, Hhd^Qhhf, Gll^Qhh, Ss, Ss, Ss, Ss, Gd, Gd, Gd^Em, Gd^Fmw, Gd^Es, Gd^Fdw, Hhd^Fdw, Gd^Fp, Ce, Hhd^Emf, Hhd, Gd^Es, Gd, Gd^Fp, Hhd^Qhhf, Gd^Em, Md, Hhd, Md, Md
Gd^Es, Gll, Gd^Em, Gd^Es, Gll^Fmw, Gd^Vo, Gll, Gll^Qhh, Gd^Fp, Gd^Qhhf, Hhd^Qhhf, Hhd^Qhhf, Hhd^Qhhf, Hhd^Qhhf, Hhd^Qhhf, Hhd^Qhh, Hhd^Qhh, Hhd^Qhh, Hhd^Qhh, Gll^Qhh, Gll^Qhh, Gll, Gd, Gd, Gd^Fmw, Gd^Fp, Gd^Fmw, Gd^Fmw, Gd^Fp, Gd^Fp, Gd^Fp, Gll^Fp, Gll^Emf, Gd^Emf, Gll^Es, Gll^Es, Gll^Efm, Gd, Hhd^Fdw, Hhd^Fdw, Md, Md^Xm, Md^Xm
Gd, Gd^Efm, Gd, Gd^Fmw, Gll^Fp, Gll, Gll, Gd^Fp, Gd^Qhhf, Gd^Qhhf, Hhd^Qhhf, Hhd^Qhhf, Hhd^Qhhf, Hhd^Qhhf, Hhd^Qhhf, Hhd^Qhhf, Hhd^Qhhf, Hhd^Qhh, Hhd^Qhh, Hhd^Qhh, Gll^Qhh, Gll, Gd, Gd^Efm, Gd, Gd^Fmw, Gd^Fmw, Gd^Fp, Gd^Fp, Gd^Fp, Gd^Fp, Gll^Fp, Gll, Gll^Es, Gll, Gll, Gll, Gd, Hhd^Fp, Hhd^Fp, Md^Xm, Md^Xm, Md^Xm
