Wog^Qhux, Wog^Qhux, Wog^Qhux, Wog^Qhux, Wog^Qhux, Wog^Qhu, Wog^Qhu, Wog^Qhu, Wog^Qhux, Wog^Qhux, Wog^Qhux, Wog^Qhux, Wog^Qhu, Wog^Qhu, Wog^Qhu, Wog^Qhux, Wog^Qhux, Wog^Qhux, Wog^Qhux, Wog^Qhux, Wog^Qhux, Wog^Qhux, Wog^Qhux, Wog^Qhu, Wog^Qhux, Wog^Qhux, Wog^Qhux, Wog^Qhux, Wog^Qhux
Wog^Qhux, Wog^Qhux, Wog^Qhux, Wog^Qhux, Wog^Qhu, Wog^Qhu, Wwg, Wog^Qhu, Wog, Wog^Qhu, Wog^Qhu, Wog^Qhu, Wog, Wog, Wog^Qhu, Wog^Qhu, Wog^Qhu, Wog^Qhu, Wog, Wog^Qhu, Wog^Qhux, Wog^Qhux, Wog^Qhu, Wog^Qhu, Wog, Wog^Qhu, Wog^Qhu, Wog^Qhux, Wog^Qhux
Wog^Qhux, Wog^Qhu, Wog^Qhu, Wog^Qhux, Wog^Qhu, Wog^Qhu, Wwrg, Wwg, Wog, Wog, Wog, Wog, Wog, Wog, Wwrg, Wog, Wog, Wog, Wog, Wog^Qhu, Wog, Wog, Wog, Wog^Qhu, Wog, Wog, Wog^Qhu, Wog^Qhux, Wog^Qhu
Wog^Qhu, Wog^Qhu, Wog, Wog^Qhu, Wwg, Wwrg, Wwrg, Wwrg, Wwg, Wwg, Wwg, Wwg, Wwg, Wwrg, Wwrg, Wwrg, Wwg, Wwg, Wwg, Wog, Wog, Wog, Wwg, Wog, Wog, Wog, Wog, Wog^Qhu, Wog^Qhu
Wog^Qhu, Wog, Wog, Wog, Wwg, Wwg, Wwf, Wwg, Wwf, Wwf, Wwf, Wwf, Wwf, Wwg, Wwf^Vm, Wwg, Wwf, Wwf^Es, Wwf^Es, Wwrg, Wwrg, Wwrg, Wwg, Wwrg, Wog, Wog, Wog, Wog^Qhu, Wog^Qhu
Wog^Qhu, Wog, Wwrg, Wwrg, Wwf, Wwf^Es, Wwf^Es, Wwf, Wwf, Wwf, Ds^Qhh, Wwf, Wwf, Wwf, Wwf, Wwf, Cme^Xo, Wwf, Wwf, Wwg, Wwf, Wwf^Es, Wwf, Wwg, Wwrg, Wwg, Wwg, Wog, Wog^Qhu
Wog^Qhu, Wog^Qhu, Wog, Wwg, Wwf, Wwf, Wwf^Es, Wwf^Es, Ds^Qhh, Ds^Qhh, Ds^Qhh, Wwf^Es, Wwf, Wwf, Wwf, Wwf, Wwf, Wwf^Es, Wwf, Wwf, Wwf^Es, Ds^Qhh, Ds^Qhh, Wwrg, Wwrg, Wwg, Wog, Wog, Wog^Qhu
Wog^Qhu, Wog, Wog, Wwrg, Wwrg, Wwf, Wwf, Wwf, Wwf, Ds^Qhh, Wwrg, Wwrg, Wwrg^Qhu, Wwrg, Wwf^Qhh, Wwf^Qhh, Wwf^Qhu, Wwf, Wwf^Qhu, Wwf, Wwf^Qhu, Ds^Qhh, Ds^Qhh, Ds^Qhh, Wwf, Wwg, Wog^Qhu, Wog^Qhu, Wog^Qhux
Wog^Qhu, Wog^Qhu, Wwrg, Wwrg, Wwrg, Wwf, Wog^Vm, Wwg, Wwf^Es, Wwf^Es, Wwf, Wwrg^Qhu, Wog^Qhh, Wwg^Qhu, Wog^Qhux, Wwf^Qhh, Km^Xo, Wwg^Qhh, Wwg^Qhh, Wwf^Qhu, Wwrg^Qhh, Wwf^Qhu, Wwf, Ds^Qhh, Wwf, Wwf, Wwg, Wog^Qhux, Wog^Qhu
Wog^Qhu, Wog^Qhu, Wwg, Wwg, Wwg, Wog, Wog, Wwg, Wwf, Wwf^Es, Wwg, Wwrg^Qhu, Cm^Xo, Wog^Qhh, Wog^Qhux, Wog^Qhux, Wog^Qhux, Wog^Qhux, Wog^Qhux, Wog^Qhux, Cm^Xo, Wwrg^Qhh, Wog^Qhu, Wwf, Wwf, Wwf, Wwg, Wog^Qhux, Wog^Qhux
Wog^Qhu, Wog, Wog, Wwg, Wog, Wwg, Wwrg, Wwg, Wwf, Wwf^Qhu, Wwg^Qhu, Wog^Qhh, Wog^Qhh, Wog^Qhux, Wog, Wog, Wog, Wog, Wog, Wog^Qhux, Wog^Qhh, Wwrg^Qhh, Wwg^Qhh, Wwf^Qhu, Wwf, Wwf, Wwg, Wog^Qhu, Wog^Qhu
Wog^Qhux, Wog^Qhu, Wog^Qhu, Wog, Wog, Wwrg, Wwrg, Wwf, Wwf^Qhu, Wwf^Qhu, Wog^Qhh, Wog^Qhh, Wog^Qhux, Wog^Qhux, Wog, Wog, Wog, Wog, Wog, Wog^Qhux, Wwg^Qhux, Wwg^Qhh, Wwg^Qhh, Wwf^Es, Wwf, Wwg^Vm, Wwrg, Wog^Qhu, Wog^Qhu
Wog^Qhux, Wog^Qhux, Wog^Qhu, Wwg, Wwg, Wwg, Wwf, Wwrg, Wwg, Wwg^Qhu, Wwg^Qhu, Wog^Qhh, Km^Xo, Wog^Qhux, Wog^Qhux, Wog, Wog, Wog, Wog^Qhux, Wog^Qhux, Km^Xo, Wog^Qhh, Wog^Qhu, Wog^Qhu, Wwf, Wwf, Wwg, Wwg, Wog^Qhu
Wog^Qhux, Wog^Qhux, Wwg, Wwg, Wwf^Es, Wwf, Wwg, Wwg, Wwf, Wwg, Wwf, Wwg^Qhu, Wwg^Qhh, Wog^Qhh, Wog^Qhux, Wog^Qhux, Cm^Xo, Wog^Qhux, Wog^Qhh, Wog^Qhh, Wog^Qhu, Wwg^Qhu, Wwf, Wog^Qhu, Wwf, Wwf, Wog, Wwg, Wog^Qhu
Wog^Qhu, Wog^Qhu, Wwg, Wwf^Es, Ds^Qhh, Ds^Qhh, Wwrg, Wog, Wog^Vm, Wwf, Wwf, Wwrg^Qhu, Wwf^Qhu, Wwg^Qhh, Wwf^Qhu, Wwg^Qhh, Wwf^Qhu, Wog^Qhh, Wog^Qhh, Wog^Qhh, Wog, Wwg, Wwf, Wwf, Wwf, Wog, Wog, Wog^Qhu, Wog^Qhux
Wog^Qhu, Wog, Wog, Wwf, Ds^Qhh, Ds^Qhh, Wwrg, Wog, Wwf, Wwf, Wwf, Wwf^Qhu, Wwf^Qhu, Wwf^Qhu, Wwf^Es, Wwf^Qhu, Wwf, Wwf^Qhu, Wwrg^Qhu, Wwg^Qhu, Wwrg, Wwg, Wwf, Wwf, Wwf^Es, Wwg, Wog, Wog^Qhux, Wog^Qhux
Wog^Qhux, Wog, Wog, Wwg, Wwf^Es, Ds^Qhh, Wwf, Wwf, Wwf^Es, Wwf, Wwf, Wwf, Wwf, Wwf^Es, Wwf, Wwf, Wwf, Wwf, Wwrg, Wwrg, Wwf, Wwf, Wwg^Vm, Wwf, Wwg, Wwrg, Wwrg, Wog, Wog^Qhu
Wog^Qhux, Wog^Qhu, Wwrg, Wwg, Wwrg, Wwf, Wwf, Wwf, Wwf, Wwf^Es, Wwf, Wwf, Wwf, Wwf, Wwf, Wwf, Wwf, Wwf, Wwf^Es, Wwf, Wwf, Wwf, Wwf^Es, Wwf, Wwg, Wwrg, Wog, Wog, Wog^Qhu
Wog^Qhu, Wog^Qhu, Wog, Wwrg, Wog, Wwg, Wog, Wwf, Wwf, Wwf, Wwf, Wwf, Wwf, Wwf, Wwf, Wwf, Wwf, Wwf, Wwf^Es, Wwf, Wwf, Ds^Qhh, Ds^Qhh, Wwf^Es, Wwg, Wwg, Wog, Wog^Qhu, Wog^Qhu
Wog^Qhux, Wog^Qhu, Wog^Qhu, Wog, Wog, Wog, Wwg, Wwf, Wwg, Wwf, Wwg, Wwg, Wog, Wog, Wwg, Wwg, Wwg, Wwf, Wwg, Wwf, Ds^Qhh, Ds^Qhh, Ds^Qhh, Wwrg, Wwrg, Wwrg, Wwg, Wog^Qhu, Wog^Qhu
Wog^Qhux, Wog^Qhu, Wog^Qhu, Wog, Wog, Wog, Wog, Wwg, Wog, Wog, Wwrg, Wwg, Wwrg, Wog, Wwg, Wwg, Wwf, Wwf, Wwf, Wwf^Es, Ds^Qhh, Ds^Qhh, Wwf, Wwg, Wwg, Wog^Qhu, Wog^Qhu, Wog^Qhu, Wog^Qhux
Wog^Qhux, Wog^Qhux, Wog^Qhux, Wog^Qhu, Wog^Qhux, Wog^Qhu, Wog^Qhu, Wog, Wog^Qhu, Wog, Wog, Wwrg, Wwg, Wwg, Wog, Wwg, Wwg, Wwf, Wog, Wwf, Wwg, Wwg, Wwg, Wwg, Wog^Qhu, Wog^Qhu, Wog^Qhux, Wog^Qhux, Wog^Qhux
Wog^Qhux, Wog^Qhux, Wog^Qhux, Wog^Qhux, Wog^Qhux, Wog^Qhux, Wog^Qhux, Wog^Qhu, Wog^Qhux, Wog^Qhux, Wog^Qhux, Wog^Qhu, Wog, Wog, Wog, Wog, Wog, Wog, Wog, Wog, Wog, Wwg, Wog, Wog, Wog, Wog^Qhu, Wog^Qhux, Wog^Qhux, Wog^Qhux
