Wog^Qhux, Wog^Qhux, Wog^Qhux, Wog^Qhux, Wog^Qhux, Wog^Qhu, Wog^Qhu, Wog^Qhu, Wog^Qhux, Wog^Qhux, Wog^Qhux, Wog^Qhux, Wog^Qhu, Wog^Qhu, Wog^Qhu, Wog^Qhux, Wog^Qhux, Wog^Qhux, Wog^Qhux, Wog^Qhux, Wog^Qhux, Wog^Qhux, Wog^Qhux, Wog^Qhu, Wog^Qhux, Wog^Qhux, Wog^Qhux, Wog^Qhux, Wog^Qhux
Wog^Qhux, Wog^Qhux, Wog^Qhux, Wog^Qhux, Wog^Qhu, Wog^Qhu, Wwg, Wog^Qhu, Wog, Wog^Qhu, Wog^Qhu, Wog^Qhu, Wog, Wog, Wog^Qhu, Wog^Qhu, Wog^Qhu, Wog^Qhu, Wog, Wog^Qhu, Wog^Qhux, Wog^Qhux, Wog^Qhu, Wog^Qhu, Wog, Wog^Qhu, Wog^Qhu, Wog^Qhux, Wog^Qhux
Wog^Qhux, Wog^Qhu, Wog^Qhu, Wog^Qhux, Wog^Qhu, Wog^Qhu, Wwrg, Wwg, Wog, Wog, Wog, Wog, Wog, Wog, Wwrg, Wog, Wog, Wog, Wog, Wog^Qhu, Wog, Wog, Wog, Wog^Qhu, Wog, Wog, Wog^Qhu, Wog^Qhux, Wog^Qhu
Wog^Qhu, Wog^Qhu, Wog, Wog^Qhu, Wwg, Wwrg, Wwrg, Wwrg, Wwg, Wwg, Wwg, Wwg, Wwg, Wwrg, Wwrg, Wwrg, Wwg, Wwg, Wwg, Wog, Wog, Wog, Wwg, Wog, Wog, Wog, Wog, Wog^Qhu, Wog^Qhu
Wog^Qhu, Wog, Wog, Wog, Wwg, Wwg, Wwf, Wwg, Ds, Wwf, Wwf, Wwf, Wwf, Wwg, Wwf^Vm, Wwg, Wwf, Wwf^Es, Wwf^Es, Wwrg, Wwrg, Wwrg, Wwg, Wwrg, Wog, Wog, Wog, Wog^Qhu, Wog^Qhu
Wog^Qhu, Wog, Wwrg, Wwrg, Wwf, Wwf^Es, Ds^Es, Ds, Ds, Ds^Ewsh, Ds^Qhh, Ds, Ds, Wwf, Ds, Ds, Cme^Xo, Ds, Wwf, Wwg, Wwf, Wwf^Es, Wwf, Wwg, Wwrg, Wwg, Wwg, Wog, Wog^Qhu
Wog^Qhu, Wog^Qhu, Wog, Wwg, Wwf, Wwf, Ds^Es, Ds^Es, Ds^Qhh, Ds^Qhh, Ds^Qhh, Ds^Es, Ds, Ds^Ewsh, Ds, Ds, Wwf, Ds^Es, Ds, Ds, Ds^Es, Ds^Qhh, Ds^Qhh, Wwrg, Wwrg, Wwg, Wog, Wog, Wog^Qhu
Wog^Qhu, Wog, Wog, Wwrg, Wwrg, Ds, Ds, Ds, Ds, Ds^Qhh, Wwrg, Wwrg, Wwrg^Qhu, Wwrg, Wwf^Qhh, Wwf^Qhh, Wwf^Qhu, Ds, Ds^Qhu, Ds, Ds^Qhu, Ds^Qhh, Ds^Qhh, Ds^Qhh, Wwf, Wwg, Wog^Qhu, Wog^Qhu, Wog^Qhux
Wog^Qhu, Wog^Qhu, Wwrg, Wwrg, Wwrg, Ds, Wog^Vm, Wwg, Ds^Es, Ds^Es, Ds, Wwrg^Qhu, Wog^Qhh, Wwg^Qhu, Wog^Qhux, Wwf^Qhh, Km^Xo, Wwg^Qhh, Wwg^Qhh, Ds^Qhu, Wwrg^Qhh, Ds^Qhu, Wwf, Ds^Qhh, Ds^Ewsh, Wwf, Wwg, Wog^Qhux, Wog^Qhu
Wog^Qhu, Wog^Qhu, Wwg, Wwg, Wwg, Wog, Wog, Wwg, Ds^Ewsh, Ds^Es, Wwg, Wwrg^Qhu, Cm^Xo, Wog^Qhh, Wog^Qhux, Wog^Qhux, Wog^Qhux, Wog^Qhux, Wog^Qhux, Wog^Qhux, Cm^Xo, Wwrg^Qhh, Wog^Qhu, Wwf, Ds, Ds, Wwg, Wog^Qhux, Wog^Qhux
Wog^Qhu, Wog, Wog, Wwg, Wog, Wwg, Wwrg, Wwg, Ds, Ds^Qhu, Wwg^Qhu, Wog^Qhh, Wog^Qhh, Wog^Qhux, Wog, Wog, Wog, Wog, Wog, Wog^Qhux, Wog^Qhh, Wwrg^Qhh, Wwg^Qhh, Ds^Qhu, Ds, Ds, Wwg, Wog^Qhu, Wog^Qhu
Wog^Qhux, Wog^Qhu, Wog^Qhu, Wog, Wog, Wwrg, Wwrg, Ds, Wwf^Qhu, Wwf^Qhu, Wog^Qhh, Wog^Qhh, Wog^Qhux, Wog^Qhux, Wog, Wog, Wog, Wog, Wog, Wog^Qhux, Wwg^Qhux, Wwg^Qhh, Wwg^Qhh, Ds^Es, Ds, Wwg^Vm, Wwrg, Wog^Qhu, Wog^Qhu
Wog^Qhux, Wog^Qhux, Wog^Qhu, Wwg, Wwg, Wwg, Ds, Wwrg, Wwg, Wwg^Qhu, Wwg^Qhu, Wog^Qhh, Km^Xo, Wog^Qhux, Wog^Qhux, Wog, Wog, Wog, Wog^Qhux, Wog^Qhux, Km^Xo, Wog^Qhh, Wog^Qhu, Wog^Qhu, Ds, Ds, Wwg, Wwg, Wog^Qhu
Wog^Qhux, Wog^Qhux, Wwg, Wwg, Wwf^Es, Ds, Wwg, Wwg, Ds, Wwg, Ds^Ewsh, Wwg^Qhu, Wwg^Qhh, Wog^Qhh, Wog^Qhux, Wog^Qhux, Cm^Xo, Wog^Qhux, Wog^Qhh, Wog^Qhh, Wog^Qhu, Wwg^Qhu, Ds, Wog^Qhu, Ds, Ds^Ewsh, Wog, Wwg, Wog^Qhu
Wog^Qhu, Wog^Qhu, Wwg, Wwf^Es, Ds^Qhh, Ds^Qhh, Wwrg, Wog, Wog^Vm, Ds, Ds, Wwrg^Qhu, Ds^Qhu, Wwg^Qhh, Wwf^Qhu, Wwg^Qhh, Wwf^Qhu, Wog^Qhh, Wog^Qhh, Wog^Qhh, Wog, Wwg, Wwf, Ds, Wwf, Wog, Wog, Wog^Qhu, Wog^Qhux
Wog^Qhu, Wog, Wog, Wwf, Ds^Qhh, Ds^Qhh, Wwrg, Wog, Ds, Ds, Ds, Ds^Qhu, Ds^Qhu, Ds^Qhu, Ds^Es, Wwf^Qhu, Ds, Wwf^Qhu, Wwrg^Qhu, Wwg^Qhu, Wwrg, Wwg, Ds, Wwf, Wwf^Es, Wwg, Wog, Wog^Qhux, Wog^Qhux
Wog^Qhux, Wog, Wog, Wwg, Wwf^Es, Ds^Qhh, Ds, Wwf, Wwf^Es, Ds, Ds, Ds, Ds, Ds^Es, Ds, Ds, Wwf, Wwf, Wwrg, Wwrg, Ds, Ds, Wwg^Vm, Ds^Ewsh, Wwg, Wwrg, Wwrg, Wog, Wog^Qhu
Wog^Qhux, Wog^Qhu, Wwrg, Wwg, Wwrg, Ds^Ewsh, Ds^Ewsh, Ds, Ds, Ds^Es, 1 Ds, Ds, Ds, Ds, Ds, Ds, Ds, Ds, Wwf^Es, Ds, Ds, Ds^Ewsh, Ds^Es, Ds, Wwg, Wwrg, Wog, Wog, Wog^Qhu
Wog^Qhu, Wog^Qhu, Wog, Wwrg, Wog, Wwg, Wog, Ds, Wwf, Ds, Ds, Ds, Ds, Ds, Ds^Ewsh, Ds, Wwf, Ds, Wwf^Es, Ds, Ds, Ds^Qhh, Ds^Qhh, Ds^Es, Wwg, Wwg, Wog, Wog^Qhu, Wog^Qhu
Wog^Qhux, Wog^Qhu, Wog^Qhu, Wog, Wog, Wog, Wwg, Wwf, Wwg, Wwf, Wwg, Wwg, Wog, Wog, Wwg, Wwg, Wwg, Wwf, Wwg, Wwf, Ds^Qhh, Ds^Qhh, Ds^Qhh, Wwrg, Wwrg, Wwrg, Wwg, Wog^Qhu, Wog^Qhu
Wog^Qhux, Wog^Qhu, Wog^Qhu, Wog, Wog, Wog, Wog, Wwg, Wog, Wog, Wwrg, Wwg, Wwrg, Wog, Wwg, Wwg, Ds, Ds, Ds^Ewsh, Ds^Es, Ds^Qhh, Ds^Qhh, Ds^Ewsh, Wwg, Wwg, Wog^Qhu, Wog^Qhu, Wog^Qhu, Wog^Qhux
Wog^Qhux, Wog^Qhux, Wog^Qhux, Wog^Qhu, Wog^Qhux, Wog^Qhu, Wog^Qhu, Wog, Wog^Qhu, Wog, Wog, Wwrg, Wwg, Wwg, Wog, Wwg, Wwg, Ds, Wog, Ds, Wwg, Wwg, Wwg, Wwg, Wog^Qhu, Wog^Qhu, Wog^Qhux, Wog^Qhux, Wog^Qhux
Wog^Qhux, Wog^Qhux, Wog^Qhux, Wog^Qhux, Wog^Qhux, Wog^Qhux, Wog^Qhux, Wog^Qhu, Wog^Qhux, Wog^Qhux, Wog^Qhux, Wog^Qhu, Wog, Wog, Wog, Wog, Wog, Wog, Wog, Wog, Wog, Wwg, Wog, Wog, Wog, Wog^Qhu, Wog^Qhux, Wog^Qhux, Wog^Qhux
