Wog, Wog, Wog, Wog, Wog, Wo, Wog, Wog, Wog, Wog, Wog, Wo, Wog, Wog, Wog, Wog, Wog, Wog, Wog, Wog, Wog
Wog, Wog, Wog, Wog, Wog, Wog, Wog, Wog, Wo, Wog, Wo, Wo, Wo, Wog, Wo, Wog, Wo, Wog, Wog, Wog, Wog
Wog, Wog, Wog, Wo, Wo, Wo, Wo, Wo, Wo, Wo, Wwr, Wo, Ww, Wo, Wo, Wo, Wo, Wog, Wo, Wog, Wog
Wog, Wog, Wo, Wo, Wo, Wo, Wo, Wo, Wwr, Wo, Wwr, Ww, Wwr, Wo, Wo, Wo, Wo, Wo, Wo, Wog, Wog
Wog, Wo, Wo, Wo, Wwr, Ww^Wkf, Wwr, Wwr, Wwr, Wwr, Ww^Wkf, Ww, Ww^Qhh, Wwr, Ww^Wkf, Ww^Wkf, Wo, Wo, Wog, Wog, Wog
Wog, Wo, Wo, Wo, Wwr, Ww^Wkf, Wwf, Wwf, Kme, Ww, Kme, Ww^Qhh, Kme, Ww^Qhh, Ww^Wkf, Wwr, Wwr, Wo, Wo, Wog, Wog
Wo, Wo, Wo, Wwr, Wwr^Qhh, Ww^Qhh, Cm^Ewl, Ds^Es, Cme, Kme, Km, Kme, Cme, Ds^Ewsh, Cm^Ewsh, Wwr, Wwr^Qhh, Wo, Wo, Wog, Wog
Wog, Wo, Wwr, Ww^Wkf, Ww^Qhh, Cme, Cm^Ewsh, Cm^Ewf, Cme^Ewl, Km^Ewf, Km, Km^Ewf, Cme, Cm^Ewl, Cm^Ewl, Cme, Ww^Qhh, Wwr, Ww, Wo, Wo
Wog, Wo, Wo, Wwr, Wwr, Ww^Qhh, Cm, Cme^Ewl, Cme, Km^Ewl, Km^Ewf, Km, Cme, Cme^Ewf, Cm, Ww^Qhh, Ww^Wkf, Wwr, Wo, Wo, Wo
Wog, Wo, Wo, Wwr, Ww^Wkf, Ww, Ww^Qhh, Cme, Ww, Ds, Ds^Ewsh, Ds, Ww^Qhh, Cme, Ww^Qhh, Ww^Qhh, Wwr, Ww, Ww, Wo, Wog
Wo, Wo, Wo, Wo, Wwr, Wwr, Ww^Wkf, Ww^Qhh, Wwr, Wwr, Wwr, Wwf, Ww^Wkf, Ww^Wkf, Ww^Wkf, Ww^Wkf, Wwr, Wwr, Ww, Wo, Wog
Wog, Wo, Wo, Wo, Wwr, Wwr, Wo, Ww, Ww, Wwr, Wwr, Ww, Ww, Ww, Wo, Wwr, Wo, Wwr, Wo, Wo, Wog
Wog, Wog, Wo, Wo, Wo, Wo, Wwrt^Qhh, Wo, Wwrt, Wwt, Wwt^Wkf, Wwt^Wkf, Wwrt, Wo, Ww^Qhh, Wo, Wo, Wo, Wog, Wo, Wog
Wog, Wog, Wog, Wog, Wwrg^Qhh, Ww^Qhh, Wwrt^Qhh, Wot^Ewl, Wot^Wkf, Wwt^Ewl, Wwrt^Ewf, Wwrt, Wot^Wkf, Wot, Wwt^Qhh, Ww^Qhh, Wwg^Qhh, Wog, Wog, Wog, Wog
Wog, Wog, Wog, Wog, Wwrg^Qhh, Wwrg^Qhh, Wwt^Qhh, Wot, Wwrt, Wwt^Ewl, Wwrt, Wwrt, Wwrt, Wot^Wkf, Wwrt^Qhh, Wwg^Qhh, Wwg^Qhh, Wog, Wog, Wog, Wog
Wog, Wog, Wog, Wwg^Qhh, Wwg^Qhh, Wwt^Qhh, Wot^Wkf, Wot^Wkf, Wwrt, Wwt^Wkf, Wwt^Wkf, Wwt^Ewf, Wwt, Wot^Wkf, Wot, Wwrt^Qhh, Wwg^Qhh, Wwrg^Qhh, Wog, Wog, Wog
Wog, Wog, Wog, Wog, Wwg^Qhh, Wwrt^Qhh, Wwt^Qhh, Wot^Wkf, Wwt^Ewl, Wwt^Ewl, Wwt, Wwrt, Wwrt, Wot^Ewl, Wo^Qhh, Wwt^Qhh, Wwg^Qhh, Wog, Wog, Wog, Wog
